##########
#   @   ##
# ### $  #
# #     .#
# $  #####
#     #  #
#.##  #  #
# #   @  #
# #     ##
##########
