##########
#   @$. ##
# ###    #
# #      #
# $  #####
#     #  #
#.##  #  #
# #   @  #
# #     ##
##########
