####################
#   #        #     #
#   #        #     #
#   #        #     #
#   #        #     #
#   #        #     #
#   #        ####  #
#   ######    @    #
#                  #
#             $    #
#   #              #
#   #              #
#   #    #    .    #
#   #    #         #
#   #    #         #
#   #    ######    #
#             #    #
#    @  .  $  #    #
#             #    #
####################