PPPPPPPPPP
P-------PP
P-PPP----P
P-P------P
P-C--PPPPP
P-----P--P
P-PP--P--P
P-P---R--P
P-P-----PP
PPPPPPPPPP
