PPPPPPPPPP
P-------PP
P-PPP----P
P-P------P
P----PPPPP
P-----P--P
P-PP--P--P
P-P------P
P-P-----PP
PPPPPPPPPP
