##########
#       ##
# ###    #
# #      #
# $  #####
#     #  #
#.##  #  #
# #   @  #
# #     ##
##########
